######
#$  .#
#    #
# @ .#
######